1111111111111111111111111
1111111111111111111111111
1111111111111111111111111
1111111111111111111111111
1111111111111111111111111
1111111111111111111111111
1111111111.....1111111111
1111111111.....1111111111
1111111111..P..1111111111
1111111111.....1111111111
1111111111.....1111111111
1111111111.....1111111111
1111111111.....1111111111
1111111111.....1111111111
1111111111.....1111111111