.........................
1111111111111111111111111
1..............M........1
1.......M...............1
1...............M.......1
1.........M........M.....
...P...........M...M.....
...................M.....
1...........M......M.....
1....M.................M.
1.........M........M.....
1..M.....................
1111111111111111111111111
1111111111111111111111111
1111111111111111111111111