.........................
1111111111111111111111111
1.......................1
1.......................1
1.......................1
1..................M.....
...P...............M.....
...................M.....
1..................M.....
1........................
1........................
1........................
1111111111111111111111111
1111111111111111111111111
1111111111111111111111111