11111111111111111111111111111111111111......111111
1.......1.......111...........11...11.......111111
1.......11........11....111.......1......11.111111
1.......1.11......1111111.1...1111......111.111111
11...1..1..11........1....1...111......11.11111111
11.11.11..11111......1....1...........1.1...111111
111..11..11....11.....1111......MMM....11.1111...1
1..11.....1......1...M..........M.........111111..1
11.11......1.....1..................1....111.....1
11.11......1......1..........M......11...........1
1.....1111.1......1.....M.......1111.11..........1
1....11...1.1....11..1.........11.....111........1
1...11...1.1.1111...1......M...1......11.........1
1..11....1.1...1..11...........1111.111..........1
1..1.....1.1.....1.................11......11....1
1..1.....111....1..................1......111....1
1..1...11.1...11...................1..1.1111.....1
1...1..1111............11.............1111.......1
11..1111111............111.........111.1.........1
1.1.....11.............1111......11111...........1
1..11....................111....11...11..........1
1....11...................111..11.....1..........1
1.....11....11....1...........11......1..........1
1.....11....11..1.11..........1.......1..........1
1....111.......11...1.........1.......1..........1
1...1.........111..1111.......1.....11...1111....1
1..1..........1...111.........111..1....111111...1
1.1...............111...........111....1111111..11
11...P..............................11.1111111.111
11111111111111111111111111111111111111111111111111